ABORT	AH B AO R T
BACK	B AE K
BACKWARD	B AE K W ER D
COME	K AH M
CONTINUE	K AH N T IH N Y UW
DOWN	D AW N
FASTER	F AE S T ER
FORWARD	F AO R W ER D
FREEZE	F R IY Z
GO	G OW
KILL	K IH L
LEFT	L EH F T
MOVE	M UW V
OFF	AO F
PANIC	P AE N IH K
PAUSE	P AO Z
RIGHT	R AY T
ROTATE	R OW T EY T
SEARCH	S ER CH
TURN	T ER N
